444444444444444477777777444444444444444477777777
400000000000000070000007400000000000000070000007
401000000000000000000007401000000000000000000007
402000P00000000000000007402000000000000000000007
403000000000000070000007403000000000000070000007
404000055555555577077777404000055555555577077777
405000050505050570007771405000050505050570007771
406000050000000570000000006000050000000570000008
407000000000000000007771407000000000000000007771
408000050000000570000008408000050000000570000008
400000050000000570007771400000050000000570007771
400000055550555577777771400000055550555577777771
666666666660666666666666666666666660666666666666
800000000000000000000004800000000000000000000004
666666066660666666666666666666066660666666666666
444444044460622222223333444444044460622222223333
400000000460620000020002400000000460620000020002
444444444444444477777777444444444444444477777777
400000000000000070000007400000000000000070000007
401000000000000000000007401000000000000000000007
402000000000000000000007402000000000000000000007
403000000000000070000007403000000000000070000007
404000055555555577077777404000055555555577077777
405000050505050570007771405000050505050570007771
406000050000000570000008406000050000000570000008
407000000000000000007771407000000000000000007771
408000050000000570000008408000050000000570000008
400000050000000570007771400000050000000570007771
400000055550555577777771400000055550555577777771
666666666660666666666666666666666660666666666666
800000000000000000000004800000000000000000000004
666666066660666666666666666666066660666666666666
444444044460622222223333444444044460622222223333
400000000460620000020002400000000460620000020002
400000000000000070000007400000000000000070000007
401000000000000000000007401000000000000000000007
402000000000000000000007402000000000000000000007
403000000000000070000007403000000000000070000007
404000055555555577077777404000055555555577077777
405000050505050570007771405000050505050570007771
406000050000000570000008406000050000000570000008
407000000000000000007771407000000000000000007771
408000050000000570000008408000050000000570000008
400000050000000570007771400000050000000570007771
400000055550555577777771400000055550555577777771
666666666660666666666666666666666660666666666666
800000000000000000000004800000000000000000000004
444444044460622222223333444444044460622222223333
400000000460620000020002400000000460620000020002
111111111111121212121212121212124213123232323323