11111
10001
10P01
10001
11011
11111